**********
X*XXXXXXXX
***X*X*XX*
X**XXXXXXX
*X**X**XX*
X**XXXXXXX
***XXX****
X*X*X*XXXX
X**X**X**X
**********